########################
# #   #                #
# #   #  ###########   #
# ## ##  #   #######   #
#       ~    #         #
#  ~     #   #     #   #
#        #####~ #####  #
#    ~   #      ##  #  #
# ~      #      ##     #
#####  ###########  #  #
####           ~    #  #
####     ~          #  #
########################