########################
#P#   #                #
# #   #  ###########   #
# ## ##  #   #######   #
#            #         #
#  ~     #   #     #   #
#        #####~ #####  #
#        #      ##  #  #
#        #      ##     #
#####  ###########  #  #
####                #  #
####     ~          #V #
########################