########################
# #   #                #
# #   #  ###########   #
# ## ##  #   #######   #
#            #         #
#  ~     #   #     #   #
#        #####~ #####  #
#        #      ##  #  #
#        #      ##     #
#####  ###########  #  #
####                #  #
####     ~          #  #
########################